111111111
110001E01
100101101
101101101
10100C101
101101001
100101011
1P1000011
111111111