1111111111111111111111111
100100000000000000000C001
1000011111000000000000001
1P0011E000000000000000001
1000000000000000000000001
1000000000000000000000001
1000000000000000000000001
1111111111111111111111111