111111111
10001P011
101000011
1001111C1
110100001
1C0001101
111110001
1E0000111
111111111
